"lang"
{
"Language"	"english" 
"Tokens"
{
"TextEntry_Cut"	"Cut"
"TextEntry_Copy"	"Copy"
"TextEntry_Paste"	"Paste"
"FileOpenDialog_Open"	"Open"
"FileOpenDialog_Save"	"Save"
"FileOpenDialog_Select"	"Select"
"FileOpenDialog_Cancel"	"Cancel"
"FileOpenDialog_Look_in"	"Look in:"
"FileOpenDialog_File_Name"	"File name:"
"FileOpenDialog_Directory_Name"	"Directory name:"
"FileOpenDialog_File_Type"	"File type:"
"FileOpenDialog_Icon"	" "
"FileOpenDialog_Name"	"Name"
"FileOpenDialog_Type"	"Type"

"SysMenu_Minimize"	" Minimize "
"SysMenu_Maximize"	" Maximize "
"SysMenu_Close"	" Close "
"Frame_Untitled"	"Untitled"
"MessageBox_OK"	"OK"
"MessageBox_Cancel"	"Cancel"
"MessageBox_Yes"	"Yes"
"MessageBox_No"	"No"
"PropertyDialog_OK"	"OK"
"PropertyDialog_Cancel"	"Cancel"
"PropertyDialog_Apply"	"Apply"
"QueryBox_Cancel"	"Cancel"
"WizardPanel_Next"	"Next >"
"WizardPanel_Back"	"< Back"
"WizardPanel_Finish"	"Finish"
"WizardPanel_Cancel"	"Cancel"
"vgui_ok"	"OK"
"vgui_close"	"Close"
"vgui_Cancel"	"Cancel"
"vgui_select"	"Select"
"vgui_createfolder"	"Create Folder..."
"vgui_next"	"Next >"
"vgui_back"	"< Back"
"vgui_TimeLeftMinutesSeconds"	"%s1 minutes %s2 seconds"
"vgui_TimeLeftMinuteSeconds"	"%s1 minute %s2 seconds"
"vgui_TimeLeftMinutesSecond"	"%s1 minutes %s2 second"
"vgui_TimeLeftMinuteSecond"	"%s1 minute %s2 second"
"vgui_TimeLeftSeconds"	"%s1 seconds"
"vgui_TimeLeftSecond"	"%s1 second"
"vgui_TimeLeftMinutesSecondsRemaining"	"%s1 minutes %s2 seconds remaining"
"vgui_TimeLeftMinuteSecondsRemaining"	"%s1 minute %s2 seconds remaining"
"vgui_TimeLeftMinutesSecondRemaining"	"%s1 minutes %s2 second remaining"
"vgui_TimeLeftMinuteSecondRemaining"	"%s1 minute %s2 second remaining"
"vgui_TimeLeftSecondsRemaining"	"%s1 seconds remaining"
"vgui_TimeLeftSecondRemaining"	"%s1 second remaining"
"vgui_CreateDirectoryFail_Title"	"Create Directory - Error"
"vgui_CreateDirectoryFail_Info"	"Failed to create directory, drive is read-only."
"vgui_CreateDirectoryFail_AlreadyExists"	"That folder already exists."

"TextEntry_Language"	"Language"
"TextEntry_ConversionMode"	"Conversion Mode"
"TextEntry_SentenceMode"	"Sentence Mode"

"IME_English"	"English"
"IME_Chinese"	"Chinese"
"IME_Korean"	"Korean"
"IME_Hiragana"	"Hiragana"
"IME_FullWidthKatakana"	"Full-width Katakana"
"IME_FullWidthAlphanumeric"	"Full-width Alphanumeric"
"IME_HalfWidthKatakana"	"Half-width Katakana"
"IME_HalfWidthAlphanumeric"	"Half-width Alphanumeric"

"IME_General"	"General"
"IME_BiasNames"	"Bias for Names"
"IME_BiasSpeech"	"Bias for Speech"
"IME_NoConversion"	"No Conversion"

"IME_0404"	"Chinese (Taiwan)"
"IME_0804"	"Chinese (PRC)"
"IME_0409"	"English (United States)"
"IME_0411"	"Japanese"
"IME_0412"	"Korean"
"IME_0419"	"Russian"
"IME_041e"	"Thai"

"IME_040c"	"French (Standard)"
"IME_0407"	"German (Standard)"
"IME_0410"	"Italian (Standard)"
"IME_040a"	"Spanish (Spain, Traditional Sort)"

"KBEditorTitle"	"Key Bindings Editor"
"KBEditorSave"	"OK"
"KBEditorCancel"	"Cancel"
"KBEditorRevert"	"Revert Changes"
"KBEditorUseDefaults"	"Use Defaults"
"KBEditorBindingName"	"Name"
"KBEditorBinding"	"Current Binding"
"KBEditorModifiers"	"Modifiers"
"KBEditorCommand"	"Command"
"KBEditorDescription"	"Description"
"KBEditor_SHIFT"	"Shift"
"KBEditor_CONTROL"	"Ctrl"
"KBEditor_ALT"	"Alt"

"KBHelpDialogTitle"	"Key Bindings Help"
"KBHelpEditBindings"	"Edit..."

"KBCustomBindingEdit"	"Custom Binding Properties"
"KBCustomBindingName"	"Binding Name"
"KBCustomBindingCommand"	"Command"

"FileOpenDialog_Col_Name"	"Name"
"FileOpenDialog_Col_Size"	"Size"
"FileOpenDialog_Col_Type"	"Type"
"FileOpenDialog_Col_DateModified"	"Date Modified"
"FileOpenDialog_Col_DateCreated"	"Date Created"
"FileOpenDialog_Col_Attributes"	"Attributes"
"FileOpenDialog_FileType_Folder"	"File Folder"
"FileOpenDialog_ToolTip_Up"	"Up"
"FileOpenDialog_ToolTip_NewFolder"	"New Folder"
"FileOpenDialog_NewFolder_InputTitle"	"New Folder"
"FileOpenDialog_NewFolderPrompt"	"Name:"
"FileOpenDialog_NewFolder_DefaultName"	"New Folder"
"FileOpenDialog_ToolTip_OpenInExplorerButton"	"Open In Explorer"

"PerforceFileList_Col_Name"	"Name"
"PerforceFileList_Col_Size"	"Size"
"PerforceFileList_Col_Type"	"Type"
"PerforceFileList_Col_Attributes"	"Attributes"
"PerforceFileList_FileType_Folder"	"File Folder"
"PerforceFileList_ToolTip_Up"	"Up One Folder"
"PerforceFileList_Col_InPerforce"	"In Perforce"
"PerforceFileList_Col_Synched"	"Synched"
"PerforceFileList_Col_Checked_Out"	"Checked Out"

"AssetBuilder_FileNew"	"New..."
"AssetBuilder_FileOpen"	"Open..."
"AssetBuilder_FileSave"	"Save"
"AssetBuilder_FileSaveAs"	"Save As..."
"AssetBuilder_AddSource"	"Add"
"AssetBuilder_RemoveSource"	"Remove"
"AssetBuilder_ApplyChanges"	"Apply"
"AssetBuilder_DuplicateSourceTitle"	"Duplicate source name!"
"AssetBuilder_DuplicateSourceText"	"This source already exists in the list of sources of this type!"
"AssetBuilder_CannotRenameSourceFiles"	"Invalid save file name!"
"AssetBuilder_CannotRenameSourceFilesText"	"Cannot compute the relative file name of some sources in this file!"
"AssetBuilder_Compile"	"Compile"
"AssetBuilder_Publish"	"Publish"
"AssetBuilder_AbortCompile"	"Abort"

"AssetPicker_Rescan"	"Rescan"

"SequencePicker_Defaults"	"Defaults"
"SequencePicker_RootMotion"	"Generate root motion"

"DmeSourceDCCFile_DuplicateSourceTitle"	"Duplicate DCC object name!"
"DmeSourceDCCFile_DuplicateSourceText"	"This DCC object already exists in the list of DCC objects!"

"DmeCombinationSystemEditor_GroupControls"	"Group Controls"
"DmeCombinationSystemEditor_UngroupControls"	"Ungroup Controls"
"DmeCombinationSystemEditor_StereoControl"	"Stereo Control"
"DmeCombinationSystemEditor_EyelidControl"	"Eyelid Control"
"DmeCombinationSystemEditor_RenameControl"	"Rename Control..."
"DmeCombinationSystemEditor_DuplicateNameTitle"	"Duplicate Control Name Specified!"
"DmeCombinationSystemEditor_DuplicateNameText"	"Control names must be unique. Please enter a different control name."
"DmeCombinationSystemEditor_AddDominationRule"	"Add Domination Rule"
"DmeCombinationSystemEditor_RemoveDominationRule"	"Remove Domination Rule"
"DmeCombinationSystemEditor_DuplicateSuppressed"	"Duplicate Suppressed"
"DmeCombinationSystemEditor_DuplicateDominators"	"Duplicate Dominators"
"DmeCombinationSystemEditor_SelectDominators"	"Select Dominators..."
"DmeCombinationSystemEditor_SelectSuppressed"	"Select Suppressed..."
"DmeCombinationSystemEditor_MoveUp"	"Move Up"
"DmeCombinationSystemEditor_MoveDown"	"Move Down"
"DmeCombinationSystemEditor_ToggleWrinkleType"	"Toggle Wrinkle Type"
"DmeCombinationSystemEditor_Import"	"Import Combination Rules..."
"DmeCombinationSystemEditor_ImportDomination"	"Import Domination Rules..."

"DmePresetGroupEditor_AddGroup"	"Add Preset Group..."
"DmePresetGroupEditor_AddPhonemeGroup"	"Add Phoneme Preset Group"
"DmePresetGroupEditor_RenameGroup"	"Rename Preset Group..."
"DmePresetGroupEditor_RemoveGroup"	"Remove Preset Group"
"DmePresetGroupEditor_ToggleVisibility"	"Toggle Group Visibility"
"DmePresetGroupEditor_ToggleSharing"	"Toggle Group Sharing"

"DmePresetGroupEditor_AddPreset"	"Add Preset..."
"DmePresetGroupEditor_RenamePreset"	"Rename Preset..."
"DmePresetGroupEditor_RemovePreset"	"Remove Preset"
"DmePresetGroupEditor_MoveUp"	"Move Up"
"DmePresetGroupEditor_MoveDown"	"Move Down"
"DmePresetGroupEditor_ImportPresets"	"Import Presets..."
"DmePresetGroupEditor_ImportPhonemes"	"Import Phonemes..."
"DmePresetGroupEditor_ExportPresets"	"Export Presets..."
"DmePresetGroupEditor_ExportPresetsToFaceposer"	"Export Presets to .TXT..."
"DmePresetGroupEditor_ExportPresetsToExpression"	"Export Presets to .VFE..."
"DmePresetGroupEditor_DuplicateNameTitle"	"Duplicate Preset Group Name Specified!"
"DmePresetGroupEditor_DuplicateNameText"	"Preset group names must be unique. Please enter a different group name."
"DmePresetGroupEditor_DuplicatePresetNameTitle"	"Duplicate Preset Name Specified!"
"DmePresetGroupEditor_DuplicatePresetNameText"	"Preset names must be unique. Please enter a different preset name."
"DmePresetGroupEditor_CannotRemovePresetGroupTitle"	"Cannot Remove Preset Group!"
"DmePresetGroupEditor_CannotRemovePresetGroupText"	"The procedural preset group cannot be removed."
"DmePresetGroupEditor_EditPresetRemapping"	"Edit Preset Remapping..."
"DmePresetGroupEditor_RemoveDefaultControls"	"Remove Default Controls"
"DmePresetGroupEditor_RemapPresets"	"Remap Presets"

"DmePresetRemapPanel_SelectPreset"	"Select Source Preset..."
"DmePresetRemapPanel_RemovePreset"	"Clear Source Preset"

"Console_Title"	"Console"
"Console_Submit"	"Submit"

// Console command panels. They should be short so translation is optional.
"vgui_fpspanel_fpscounter_1"	"%3i fps on %s"
"vgui_fpspanel_fpscounter_2"	"%3i fps (%3i, %3i) smth:%4.1f ms frm:%4.1f ms on %s"
"vgui_fpspanel_fpscounter_3"	"server %5.1f ms curr, %5.1f ave, %5.1f peak"
"vgui_fpspanel_fpscounter_4"	"Avg FPS %3i, Frame MS %5.1f, Frame Server MS %5.1f"

"vgui_fpspanel_position_playername"	"name: %s"
"vgui_fpspanel_position_currentposition"	"pos:  %.02f %.02f %.02f"
"vgui_fpspanel_position_angle"	"ang:  %.02f %.02f %.02f"
"vgui_fpspanel_position_velocity"	"vel:  %.2f"

"vgui_fpspanel_blocking_history"	"[%8.3f ms]"

"vgui_fpspanel_particle_fps"	"Particle Performance Metric : %d"

"vgui_netgraph_1_fps_x_ping_x"	"fps:%4i   ping: %i ms"
"vgui_netgraph_1_download_x"	"in: %4i   %2.2f k/s  "
"vgui_netgraph_1_download_x_width"	"in: 1234   12.34 k/s  "
"vgui_netgraph_1_interp_x"	"lerp: %5.0f ms"
"vgui_netgraph_1_fps_x_ping_x_interp_x"	"fps:  435  ping: 533 ms lerp 112.3 ms   0/0"
"vgui_netgraph_1_upload_x"	"out:%4i   %2.2f k/s"
"vgui_netgraph_1_upload_second"	"%3.1f/s"
"vgui_netgraph_1_update_rate_second"	"%i/s"
"vgui_netgraph_1_command_rate_second"	"%i/s"
"vgui_netgraph_2_packet_loss_x_choke_x"	"loss:%3i   choke: %2i  "
"vgui_netgraph_3_tick_x_fps_x_deviation_x"	"tick:%3i   sv: %5.1f  var: %4.2f msec"
"vgui_netgraph_5_graph_local_player"	"localplayer"
"vgui_netgraph_5_graph_other_players"	"otherplayers"
"vgui_netgraph_5_graph_entities"	"entities"
"vgui_netgraph_5_graph_sounds"	"sounds"
"vgui_netgraph_5_graph_events"	"events"
"vgui_netgraph_5_graph_temporary_entities"	"tempents"
"vgui_netgraph_5_graph_user_messages"	"usermessages"
"vgui_netgraph_5_graph_entity_messages"	"entmessages"
"vgui_netgraph_5_graph_string_commands"	"stringcmds"
"vgui_netgraph_5_graph_string_tables"	"stringtables"
"vgui_netgraph_5_graph_voice"	"voice"
}
}
